00000000000000000000000000000000000000000000000000000000
00000000000000000000000000000000000000000000000000000000
00000000000000000000000000000000000000000000000000000000
00000000000000000000000000000000000000000000000000000000
00000000000000000000000000000000000000000000000000000000
00000000000000000000000000000000000000000000000000000000
00000000000000000000000000000000000000000000000000000000
00000000000000000000000000000000000000000000000000000000
00000000000000000000000000000000000000000000000000000000
00000000000000000000000000000000000000000000000000000000
00000000000000000000000000000000000000000000000000000000
00000000000000000000000000000000000000000000000000000000
00000000000000000000000000000000000000000000000000000000
00000000000000000000000000000000000000000000000000000000
00000000000000000000000000000000000000000000000000000000
00000000000000000000000000000000000000000000000000000000
00000000000000000000000000000000000000000000000000000000
00000000000000000000000000000000000000111110000000000000
00000000000000000000000000000000000000000000000000000000
00000000000000000000000111111110000000000000000000000000
00000000000000000000000000000000000000000000000000000000
00011100000000000000000000000000000000000000000001111000
00011110000000000000000000000000000000000000000001111000
11111111111111111111111111111111111111111111111111111111
22222222222222222222222222222222222222222222222222222222
22222222222222222222222222222222222222222222222222222222
22222222222222222222222222222222222222222222222222222222
22222222222222222222222222222222222222222222222222222222
22222222222222222222222222222222222222222222222222222222
22222222222222222222222222222222222222222222222222222222
22222222222222222222222222222222222222222222222222222222